Xuc, Xu, Xuc, Xu, Xu, Xuc, Xu, Xu, Xu, Xu, Xu, Xu, Xu, Xu, Xu, Xu, Xu, Xu, Xu, Xu, Xu, Xu, Xu, Xu, Xu, Xu, Xu, Xu, Xu, Xu, Xu, Xu, Xu, Xu, Xu, Xu, Xu, Xu, Xu, Xu, Xu, Xu, Xu, Xu
Xoc, Xoc, Xoc, Xoc, Xu, Xuc, Ur, Ur, Ur, Ur, Qxua, Qxua, Qxua, Qxua, Qxua, Qxua, Qxua, Ur, Ur, Ur, Qxua, Qxua, Qxua, Qxua, Ur, Ur, Ur, Qxua, Qxua, Ur, Ur, Ur, Qxua, Qxua, Ur, Ur, Ur, Ur, Cud, Cud, Cud, Cud, Xu, Xu
Xoc, Xoc, Xoc, Xoc, Xu, Xuc, Ur, Ur, Ur, Ur, Qxua, Qxua, Ur, Qxua, Qxua, Qxua, Qxua, Ur, Uu^Vu, Ur, Ur, Ur, Qxua, Qxua, Ur, Uu^Vu, Ur, Qxua, Qxu^Bs/, Ur, Ur, Ur, Ur, Qxu^Bs/, Qxua, Ur, Ur, Cud, 3 Kud, Cud, 5 Kud, Cud, Xu, Xu
Xoc, Xoc, Xoc, Xoc, Xu, Xuc, Ur, Ur, Ur, Ur, Ur, Qxua, Ur, Ur, Qxua, Qxua, Qxua, Qxua, Ur, Ur, Qxua, Ur, Ur, Qxua, Qxua, Ur, Ur, Ur, Qxua, Qxua, Qxua, Ur, Qxua, Qxua, Qxua, Ur, Ur, Cud, Cud, Cud, Cud, Cud, Xu, Xu
Xoc, Xoc, Xoc, Xoc, Xu, Xuc, Ur, Ur, Ur, Uu^Vu, Ur, Ur, Ur, Ur, Ur, Qxua, Qxu^Bs/, Ur, Ur, Ur, Qxua, Qxua, Qxua, Qxu^Bs\, Ur, Ur, Ur, Qxua, Qxua, Qxua, Qxua, Qxu^Bs|, Qxua, Qxua, Qxua, Ur, Ur, Ur, Cud, 1 Kud, Cud, Cud, Xu, Xu
Xoc, Xoc, Xoc, Xoc, Xu, Xuc, Ur, Ur, Ur, Ur, Ur, Qxua, Ur, Ur, Qxua, Ur, Qxua, Qxua, Qxu^Bs|, Qxua, Qxua, Qxua, Qxua, Qxua, Qxua, Ur, Qxua, Qxua, Qxua, Qxua, Ur, Ur, Qxua, Qxua, Qxua, Ur, Ur, Cud, 2 Kud, Cud, 4 Kud, Cud, Xu, Xu
Xoc, Xoc, Xoc, Xoc, Xu, Xuc, Qxua, Ur, Qxua, Ur, Qxu^Bs|, Qxua, Qxua, Qxua, Qxua, Qxua, Qxua, Qxua, Ur, Qxua, Ur, Ur, Ur, Qxua, Qxua, Qxu^Bs|, Qxua, Qxua, Qxua, Qxua, Ur, Ur, Qxua, Qxua, Qxua, Ur, Ur, Cud, Cud, Cud, Cud, Cud, Xu, Xu
Xoc, Xoc, Xoc, Xoc, Xu, Xuc, Qxua, Qxu^Bs|, Ur, Qxua, Ur, Qxua, Qxua, Qxua, Qxua, Qxua, Qxua, Ur, Ur, Ur, Ur, Ur, Qxua, Qxu^Bs\, Ur, Ur, Ur, Ur, Ur, Qxu^Bs/, Ur, Ur, Ur, Qxua, Qxua, Qxua, Ur, Ur, Ur, Ur, Ur, Ur, Xu, Xu
Xoc, Xoc, Xoc, Xoc, Xuc, Xuc, Ur, Ur, Ur, Ur, Ur, Ur, Ur, Qxua, Qxua, Qxua, Qxu^Bs/, Ur, Ur, Uu^Vu, Ur, Ur, Qxua, Qxua, Ur, Ur, Uu^Vu, Ur, Ur, Qxua, Ur, Ur, Uu^Vu, Ur, Ur, Qxu^Bs/, Qxua, Ur, Qxua, Ur, Qxua, Qxua, Xu, Xu
Xoc, Xoc, Xuc, Xuc, Xu, Xuc, Ur, Ur, Ur, Uu^Vu, Ur, Ur, Qxu^Bs\, Qxua, Ur, Ur, Qxua, Qxua, Ur, Ur, Ur, Qxua, Qxua, Qxua, Qxua, Ur, Ur, Ur, Qxua, Qxua, Qxua, Ur, Ur, Ur, Ur, Qxua, Qxua, Qxua, Qxua, Qxua, Qxua, Qxua, Xu, Xu
Xuc, Xuc, Xoc, Xoc, Xu, Xuc, Qxua, Ur, Qxua, Ur, Ur, Qxua, Qxua, Ur, Uu^Vu, Qxua, Qxua, Qxua, Qxua, Ur, Qxua, Qxu^Bs\, Ur, Qxua, Qxu^Bs/, Ur, Ur, Ur, Ur, Qxua, Qxua, Qxua, Qxu^Bs/, Ur, Ur, Ur, Qxua, Qxua, Qxua, Qxua, Qxua, Qxua, Xu, Xu
Xoc, Xoc, Xoc, Xoc, Xu, Xuc, Qxua, Ur, Qxua, Qxua, Qxua, Qxua, Qxua, Qxua, Ur, Qxua, Qxua, Qxua, Qxua, Qxua, Ur, Ur, Ur, Ur, Ur, Qxua, Ur, Ur, Ur, Ur, Ur, Ur, Qxua, Qxua, Qxua, Qxu^Bs\, Ur, Ur, Ur, Ur, Ur, Ur, Xu, Xu
Xuc, Xuc, Xuc, Xoc, Xu, Xuc, Qxua, Qxu^Bs|, Ur, Qxua, Qxua, Qxua, Qxua, Qxua, Qxua, Ur, Qxua, Qxua, Qxua, Qxua, Ur, Ur, Ur, Ur, Ur, Qxua, Qxu^Bs/, Ur, Ur, Ur, Qxua, Ur, Qxu^Bs\, Qxua, Qxua, Qxua, Ur, Ur, Ur, Uu^Vu, Ur, Ur, Xu, Xu
Xoc, Xuc, Xoc, Xoc, Xu, Xuc, Qxua, Ur, Ur, Ur, Qxua, Qxua, Qxua, Qxua, Qxua, Qxu^Bs|, Qxua, Qxua, Qxu^Bs/, Ur, Ur, Ur, Ur, Uu^Vu, Ur, Ur, Ur, Qxua, Qxua, Qxua, Qxua, Qxua, Qxua, Ur, Ur, Qxua, Ur, Ur, Ur, Ur, Ur, Ur, Xu, Xu
Xoc, Xoc, Xoc, Xoc, Xu, Xuc, Ur, Uu^Vu, Ur, Ur, Qxu^Bs\, Ur, Ur, Qxua, Ur, Ur, Ur, Ur, Qxua, Qxua, Qxua, Ur, Ur, Ur, Ur, Ur, Qxua, Qxua, Qxua, Qxua, Qxua, Qxua, Ur, Ur, Ur, Qxu^Bs/, Qxua, Ur, Ur, Ur, Ur, Ur, Xu, Xu
Xoc, Xoc, Xoc, Xoc, Xu, Xuc, Ur, Ur, Qxua, Qxua, Ur, Ur, Ur, Ur, Qxua, Qxua, Qxua, Qxua, Qxua, Qxua, Qxua, Qxua, Qxua, Ur, Ur, Ur, Qxu^Bs\, Qxua, Qxua, Qxua, Qxua, Ur, Ur, Ur, Uu^Vu, Qxua, Qxua, Qxua, Qxua, Qxua, Qxua, Qxua, Xu, Xu
Xoc, Xoc, Xoc, Xu, Xu, Xuc, Ur, Ur, Qxua, Qxua, Ur, Ur, Ur, Uu^Vu, Qxua, Qxua, Ur, Qxua, Ur, Qxua, Ur, Qxua, Qxua, Qxua, Qxua, Qxua, Ur, Ur, Ur, Ur, Ur, Qxu^Bs/, Qxua, Ur, Ur, Ur, Qxua, Qxua, Qxua, Qxua, Qxua, Qxua, Xu, Xu
Xu, Xoc, Xu, Xu, Xu, Xuc, Qxu^Bs\, Qxua, Qxua, Qxua, Qxu^Bs|, Qxua, Qxua, Qxu^Bs\, Ur, Ur, Ur, Ur, Ur, Uu^Vu, Ur, Ur, Ur, Qxua, Qxua, Ur, Ur, Ur, Ur, Ur, Ur, Qxua, Qxua, Qxua, Qxua, Qxu^Bs\, Ur, Qxua, Ur, Qxua, Qxua, Qxua, Xu, Xu
Xoc, Xoc, Xoc, Xu, Xu, Xuc, Qxua, Ur, Ur, Qxua, Ur, Qxua, Qxua, Qxua, Ur, Ur, Qxua, Qxua, Qxua, Ur, Ur, Ur, Qxua, Qxua, Qxu^Bs/, Ur, Ur, Uu^Vu, Ur, Ur, Qxua, Qxua, Qxua, Qxua, Qxua, Qxua, Ur, Ur, Ur, Ur, Ur, Qxua, Xu, Xu
Xoc, Xoc, Xoc, Xoc, Xu, Xuc, Ur, Ur, Ur, Ur, Ur, Ur, Ur, Qxu^Bs/, Qxua, Qxua, Qxua, Qxua, Qxua, Qxua, Qxua, Qxu^Bs\, Ur, Ur, Qxua, Qxua, Qxua, Ur, Ur, Ur, Qxua, Qxua, Ur, Qxua, Qxua, Qxua, Ur, Ur, Ur, Ur, Uu^Vu, Ur, Xu, Xu
Xoc, Xoc, Xoc, Xoc, Xu, Xuc, Ur, Ur, Ur, Uu^Vu, Ur, Ur, Ur, Qxua, Qxua, Qxua, Qxua, Qxua, Ur, Ur, Qxua, Qxua, Ur, Ur, Ur, Qxua, Qxua, Qxua, Qxua, Qxu^Bs\, Ur, Ur, Ur, Ur, Ur, Qxu^Bs/, Qxua, Ur, Qxua, Ur, Ur, Ur, Xu, Xu
Xoc, Xoc, Xoc, Xu, Xu, Xuc, Ur, Ur, Qxu^Bs|, Qxua, Qxua, Ur, Qxu^Bs\, Qxua, Qxua, Qxua, Ur, Ur, Ur, Uu^Vu, Ur, Qxu^Bs/, Qxua, Ur, Ur, Ur, Qxua, Qxua, Qxua, Qxua, Ur, Ur, Ur, Uu^Vu, Ur, Qxua, Qxua, Qxua, Qxua, Ur, Ur, Ur, Xu, Xu
Xuc, Xoc, Xoc, Xu, Xu, Xuc, Qxua, Qxua, Ur, Qxua, Qxua, Qxua, Ur, Ur, Ur, Qxu^Bs/, Qxua, Ur, Ur, Ur, Ur, Qxua, Qxua, Ur, Uu^Vu, Ur, Qxua, Qxua, Qxua, Ur, Qxua, Ur, Ur, Ur, Qxua, Qxua, Qxua, Qxua, Ur, Qxu^Bs/, Qxua, Ur, Xu, Xu
Xuc, Xoc, Xoc, Xu, Xu, Xuc, Qxua, Qxua, Ur, Qxua, Qxu^Bs/, Ur, Ur, Ur, Ur, Qxua, Qxua, Qxua, Qxua, Ur, Qxua, Qxua, Qxua, Ur, Ur, Ur, Ur, Ur, Ur, Qxu^Bs|, Qxua, Qxua, Qxua, Qxu^Bs\, Ur, Ur, Ur, Ur, Ur, Ur, Ur, Qxua, Xu, Xu
Xoc, Xoc, Xu, Xu, Xu, Xuc, Ur, Ur, Ur, Ur, Qxua, Qxua, Ur, Ur, Ur, Ur, Qxua, Qxua, Qxua, Qxua, Qxua, Qxua, Qxua, Ur, Ur, Ur, Ur, Ur, Ur, Ur, Qxua, Qxua, Qxua, Qxua, Qxua, Ur, Ur, Ur, Ur, Ur, Uu^Vu, Ur, Xu, Xu
Xoc, Xoc, Xoc, Xu, Xu, Xuc, Ur, Uu^Vu, Ur, Ur, Qxua, Qxua, Qxu^Bs|, Qxua, Qxua, Ur, Qxu^Bs\, Qxua, Qxua, Ur, Ur, Qxua, Qxu^Bs/, Ur, Ur, Ur, Ur, Ur, Ur, Ur, Qxua, Qxua, Qxua, Qxua, Qxua, Qxua, Qxua, Ur, Ur, Ur, Ur, Ur, Xu, Xu
Xoc, Xoc, Xu, Xu, Xu, Xuc, Ur, Ur, Qxu^Bs\, Qxua, Ur, Qxua, Ur, Qxua, Qxua, Qxua, Qxua, Ur, Ur, Ur, Uu^Vu, Ur, Qxua, Qxua, Qxua, Ur, Ur, Ur, Ur, Ur, Ur, Qxua, Qxua, Qxua, Qxua, Qxua, Qxua, Qxua, Ur, Ur, Ur, Ur, Xu, Xu
Xoc, Xoc, Xoc, Xu, Xu, Xuc, Qxua, Qxua, Qxua, Ur, Ur, Ur, Ur, Ur, Ur, Qxua, Ur, Qxu^Bs/, Qxua, Qxua, Qxua, Ur, Ur, Qxua, Qxua, Qxua, Qxua, Ur, Ur, Ur, Ur, Ur, Qxua, Qxua, Ur, Qxua, Qxua, Qxua, Qxua, Ur, Qxua, Qxua, Xu, Xu
Xoc, Xoc, Xoc, Xu, Xu, Xuc, Qxua, Qxua, Qxua, Ur, Ur, Ur, Uu^Vu, Ur, Ur, Ur, Qxua, Qxua, Qxua, Qxua, Ur, Ur, Ur, Qxua, Qxua, Qxua, Ur, Qxu^Bs/, Qxua, Qxua, Qxua, Qxu^Bs\, Ur, Ur, Ur, Qxua, Qxua, Qxua, Qxua, Qxu^Bs|, Qxua, Qxua, Xu, Xu
Xoc, Xoc, Xu, Xu, Xu, Xuc, Qxua, Qxua, Qxu^Bs/, Ur, Ur, Ur, Ur, Ur, Qxua, Ur, Qxu^Bs\, Qxua, Ur, Qxu^Bs/, Qxua, Qxua, Qxua, Ur, Qxu^Bs\, Ur, Ur, Qxua, Qxua, Qxua, Qxu^Bs/, Ur, Qxua, Ur, Ur, Ur, Ur, Qxua, Qxua, Ur, Ur, Ur, Xu, Xu
Xoc, Xoc, Xu, Xu, Ur, Xuc, Ur, Ur, Ur, Qxua, Qxua, Qxua, Qxua, Ur, Ur, Qxua, Ur, Uu^Vu, Qxua, Qxua, Qxua, Qxua, Qxua, Qxua, Ur, Ur, Ur, Qxua, Ur, Ur, Ur, Qxua, Qxua, Qxua, Qxua, Ur, Ur, Ur, Ur, Ur, Ur, Uu^Vu, Xu, Xu
Xoc, Xoc, Xu, Ur, Ur, Ur, Ur, Ur, Ur, Ur, Qxua, Qxua, Qxua, Qxua, Qxu^Bs|, Qxua, Qxua, Qxu^Bs\, Ur, Qxua, Qxua, Qxua, Qxua, Qxua, Ur, Ur, Qxua, Qxua, Ur, Ur, Ur, Ur, Qxua, Qxua, Qxua, Qxua, Qxua, Ur, Qxua, Ur, Qxua, Qxua, Xu, Xu
Xoc, Xoc, Xu, Ur, Xu, Xuc, Ur, Ur, Ur, Uu^Vu, Qxua, Qxua, Qxua, Qxua, Ur, Qxua, Ur, Ur, Ur, Qxua, Qxua, Qxua, Ur, Ur, Ur, Ur, Ur, Qxua, Qxua, Ur, Ur, Uu^Vu, Ur, Qxua, Qxua, Qxua, Qxua, Qxu^Bs|, Qxua, Qxua, Qxua, Qxua, Xu, Xu
Xoc, Xoc, Xu, Xu, Xu, Xuc, Ur, Ur, Ur, Ur, Qxua, Qxua, Qxua, Qxua, Ur, Ur, Ur, Uu^Vu, Qxua, Qxua, Qxua, Qxua, Ur, Ur, Ur, Uu^Vu, Ur, Qxua, Qxu^Bs/, Ur, Ur, Ur, Ur, Qxua, Qxua, Qxua, Ur, Ur, Ur, Qxua, Qxua, Qxua, Xu, Xu
Xoc, Xoc, Xoc, Xoc, Xu, Xuc, Ur, Ur, Ur, Ur, Qxu^Bs\, Qxua, Ur, Qxua, Qxua, Ur, Ur, Ur, Qxu^Bs\, Qxua, Ur, Qxu^Bs/, Qxua, Qxua, Qxua, Ur, Qxua, Ur, Qxua, Qxua, Qxua, Ur, Qxua, Qxu^Bs\, Ur, Ur, Ur, Ur, Ur, Ur, Ur, Ur, Xu, Xu
Xoc, Xoc, Xoc, Xoc, Xu, Xuc, Qxua, Ur, Qxua, Qxua, Ur, Ur, Ur, Ur, Ur, Qxu^Bs/, Qxua, Qxua, Qxua, Ur, Ur, Qxua, Ur, Qxua, Qxua, Qxua, Qxua, Qxu^Bs|, Qxua, Qxua, Qxua, Qxua, Qxua, Qxua, Ur, Ur, Ur, Uu^Vu, Ur, Ur, Ur, Ur, Xu, Xu
Xoc, Xoc, Xoc, Xoc, Xu, Xuc, Qxua, Qxua, Qxua, Ur, Ur, Ur, Ur, Ur, Ur, Qxua, Qxua, Qxua, Ur, Ur, Uu^Vu, Ur, Ur, Qxua, Qxua, Qxua, Qxua, Ur, Ur, Ur, Ur, Ur, Qxua, Qxua, Qxu^Bs|, Qxua, Qxua, Qxua, Qxu^Bs|, Qxua, Qxua, Qxua, Xu, Xu
Xu, Xu, Xu, Xu, Xu, Xuc, Ur, Qxua, Qxu^Bs/, Ur, Qxua, Ur, Ur, Uu^Vu, Qxua, Qxua, Qxua, Qxua, Qxu^Bs/, Ur, Qxua, Ur, Qxu^Bs\, Qxua, Qxua, Qxua, Qxu^Bs/, Ur, Ur, Ur, Ur, Ur, Ur, Qxua, Ur, Qxua, Qxua, Qxua, Ur, Qxua, Ur, Qxua, Xu, Xu
Xu, Xu, Xu, Xu, Xu, Xuc, Ur, Ur, Qxua, Qxua, Qxua, Qxua, Qxu^Bs|, Qxua, Qxua, Qxua, Ur, Ur, Qxua, Qxua, Qxua, Qxua, Ur, Ur, Ur, Ur, Ur, Qxua, Qxua, Ur, Ur, Uu^Vu, Ur, Ur, Ur, Ur, Qxua, Qxua, Ur, Ur, Ur, Ur, Xu, Xu
Xu, Xu, Xu, Xu, Xu, Xuc, Ur, Ur, Uu^Vu, Qxua, Qxua, Qxua, Ur, Qxua, Qxua, Ur, Ur, Ur, Ur, Qxua, Qxu^Bs/, Ur, Ur, Ur, Uu^Vu, Ur, Ur, Qxua, Qxua, Qxua, Qxu^Bs|, Qxua, Qxua, Qxua, Qxua, Qxu^Bs\, Ur, Ur, Ur, Ur, Ur, Ur, Xu, Xu
Xoc, Xoc, Xoc, Xu, Xu, Xuc, Ur, Ur, Ur, Ur, Qxua, Ur, Ur, Ur, Ur, Qxu^Bs/, Ur, Ur, Uu^Vu, Ur, Qxua, Qxua, Ur, Ur, Ur, Ur, Ur, Qxu^Bs\, Ur, Qxua, Ur, Qxua, Qxua, Qxua, Qxua, Qxua, Ur, Ur, Ur, Ur, Ur, Uu^Vu, Xu, Xu
Xoc, Xoc, Xoc, Xu, Xu, Xuc, Ur, Ur, Ur, Ur, Qxu^Bs/, Ur, Ur, Uu^Vu, Ur, Qxua, Qxua, Ur, Qxua, Ur, Qxu^Bs\, Qxua, Qxua, Ur, Ur, Ur, Qxua, Qxua, Qxua, Ur, Ur, Ur, Ur, Ur, Ur, Qxu^Bs/, Qxua, Ur, Qxua, Ur, Ur, Ur, Xu, Xu
Xoc, Xoc, Xu, Xu, Xu, Xuc, Ur, Ur, Qxua, Ur, Qxua, Ur, Ur, Ur, Ur, Qxua, Qxua, Qxua, Qxua, Qxua, Ur, Ur, Ur, Qxu^Bs/, Qxua, Qxua, Qxua, Qxua, Qxu^Bs/, Ur, Ur, Ur, Uu^Vu, Ur, Ur, Ur, Qxua, Qxua, Qxua, Qxua, Qxu^Bs|, Qxua, Xu, Xu
Xoc, Xu, Xu, Xu, Xu, Xuc, Qxua, Qxu^Bs\, Ur, Qxua, Qxua, Qxua, Ur, Ur, Cud, Cud, Qxua, Qxua, Qxua, Cud, Cud, Ur, Uu^Vu, Qxua, Ur, Qxua, Ur, Ur, Ur, Qxua, Qxua, Ur, Ur, Ur, Ur, Ur, Qxu^Bs\, Qxua, Ur, Qxua, Ur, Qxua, Xu, Xu
Xu, Xu, Xu, Xu, Xu, Xuc, Qxua, Qxua, Ur, Ur, Qxua, Qxua, Qxu^Bs|, Qxua, Ur, Ur, Qxua, Qxua, Qxu^Bs/, Ur, Qxua, Ur, Ur, Ur, Ur, Qxu^Bs\, Ur, Ur, Uu^Vu, Qxua, Qxua, Qxua, Qxua, Qxua, Ur, Ur, Qxua, Ur, Ur, Ur, Uu^Vu, Ur, Xu, Xu
Xu, Xu, Ur, Ur, Ur, Xuc, Ur, Uu^Vu, Ur, Ur, Qxua, Qxua, Ur, Qxua, Qxua, Qxu^Bs\, Cud, Cud, Cud, Qxua, Qxua, Ur, Cud, Cud, Cud, Qxua, Ur, Ur, Ur, Ur, Qxu^Bs\, Ur, Ur, Qxu^Bs/, Qxua, Qxua, Qxua, Qxua, Qxua, Ur, Ur, Ur, Xu, Xu
Xu, Xu, Ur, Ur, Ur, Ur, Ur, Ur, Qxu^Bs\, Qxua, Ur, Cud, Ur, Ur, Qxua, Cud, Cud, Cud, Cud, Cud, Qxua, Qxua, Qxua, Ur, Qxua, Qxua, Qxu^Bs|, Qxua, Qxua, Ur, Qxua, Ur, Ur, Qxua, Ur, Qxua, Qxua, Qxua, Qxua, Qxua, Ur, Ur, Xu, Xu
Xu, Xu, Ur, Ur, Xu, Xuc, Ur, Qxua, Qxua, Ur, Ur, Cud, Cud, Ur, Qxua, Cud, Cud, 9 Kud, Cud, Cud, Qxua, Qxua, Qxua, Qxu^Bs|, Qxua, Qxua, Ur, Qxua, Qxua, Qxua, Qxua, Qxua, Ur, Uu^Vu, Ur, Ur, Qxua, Qxua, Ur, Qxu^Bs/, Qxua, Ur, Xu, Xu
Xu, Xu, Xu, Xu, Xu, Xuc, Qxua, Qxua, Qxua, Ur, Ur, Ur, Qxua, Qxu^Bs\, Ur, Qxu^Bs/, Qxua, Cud, Qxua, Qxu^Bs\, Ur, Ur, Qxu^Bs\, Ur, Cud, Ur, Ur, Qxua, Qxua, Qxua, Ur, Qxu^Bs/, Qxua, Ur, Qxua, Ur, Qxu^Bs\, Qxua, Ur, Ur, Ur, Qxua, Xu, Xu
Xu, Xu, Xu, Xu, Xu, Xuc, Ur, Qxua, Ur, Qxu^Bs/, Qxua, Qxua, Qxua, Qxua, Cud, Ur, Qxua, Qxua, Ur, Qxua, Cud, Ur, Qxua, Ur, Cud, Ur, Ur, Uu^Vu, Qxua, Qxua, Ur, Ur, Ur, Qxua, Qxua, Qxua, Ur, Ur, Ur, Ur, Ur, Ur, Xu, Xu
Xoc, Xu, Xu, Xu, Xu, Xuc, Ur, Ur, Ur, Uu^Vu, Ur, Ur, Qxu^Bs/, Ur, Ur, Cud, Ur, Qxua, Ur, Ur, Ur, Cud, Qxua, Cud, Ur, Ur, Ur, Ur, Qxu^Bs\, Ur, Ur, Uu^Vu, Ur, Qxua, Qxua, Ur, Ur, Ur, Ur, Uu^Vu, Ur, Ur, Xu, Xu
Xu, Xu, Xu, Xu, Xu, Xuc, Ur, Ur, Ur, Ur, Ur, Ur, Qxua, Qxua, Qxua, Ur, Ur, Qxu^Bs/, Ur, Uu^Vu, Ur, Qxua, Ur, Ur, Ur, Ur, Qxua, Qxua, Ur, Ur, Ur, Ur, Qxua, Qxu^Bs\, Ur, Ur, Ur, Ur, Ur, Ur, Ur, Ur, Xu, Xu
Xu, Xu, Xoc, Xu, Xu, Xuc, Xu, Xuc, Xu, Xuc, Xu, Xuc, Xuc, Xuc, Xuc, Xuc, Xuc, Xuc, Xuc, Xuc, Xuc, Xuc, Xuc, Xuc, Xuc, Xuc, Xuc, Xuc, Xuc, Xuc, Xuc, Xuc, Xuc, Xuc, Xuc, Xuc, Xuc, Xuc, Xuc, Xuc, Xuc, Xuc, Xu, Xu
Xoc, Xoc, Xu, Xu, Xu, Xu, Xu, Xu, Xu, Xu, Xu, Xu, Xu, Xu, Xu, Xu, Xu, Xuc, Xu, Xuc, Xu, Xu, Xu, Xu, Xu, Xu, Xu, Xuc, Xu, Xuc, Xu, Xu, Xu, Xu, Xu, Xu, Xu, Xu, Xu, Xuc, Xu, Xuc, Xu, Xu
